smH=Message from System
pageH=Create Insurance for docket
tiH=Travelling Information
desH=Destination
ddlOEur=Europe
ddlOUS=United States
ddlOAs=Asia
ddlOCSA=Center and South America
ddlOAu=Austrelia / New Zeland
ddlOAf=Africa
ddlOCan=Canada
fromH=From
toH=To
piH=Personal information of the main traveller
idH=Id
fnH=First Name
lnH=Last Name
pnH=Phone Number
mlH=Email Address
dobH=Date of Birth
adH=Add additional travellers
genH=Gender
ddlOM=Male
ddlOF=Female
ddlOU=Other
atB=Add Traveller to Trip
etlB=Edit Traveller List
subB=Find Policy
fpB=Finish Process
dirM=Please confirm the created policy via email before clicking on 'Finish Process' button
idM=Please enter exactly 9 digits for id.
fnM=Enter your client's name in English
rtC=Are you sure you want to delete this traveller from your travellers list?
mlM=Email address is not valid. Please enter an adress in english using the strudel sign and one dot or more.
popME=Cannot be empty
popMR=is not in the Right Format (Check length or Necessary Characters)
popMdates=To-Date is happening before From-Date
popMdate=From-Date already happened
popMprim=The main traveller's id cannot be empty
popMSp=Phone number cannot be empty
popMSn=Main traveller's name cannot be empty
popMUS=Docket @ updated successfully
fnM2=Traveller's first name
dobM=The date of birth of
popMConP=Client needs to confirm the offer
popMF=
ohCMrem=Are you sure you want to delete this row from the table?
ohH=Orders History
ohThS=Order status
ohThCO=Created on
ohThCI=Client's id
ohThFN=Full name
ohThDes=Destination
ohThFD=From Date
ohThTD=To Date
ohThSP=Pending
ohThSC=Completed
ohPopMEr=There is a proplem with this issue. Please make a new one.
excMess_SuppName=Supplier name is not known. Code:
excMess_CrtDocket=There was a problem creating or updating the docket.
lbl_DocketId=Docket Number
mess_CrtDocket=Create the inserted PNR in the entered docket number
ddlTxt_DocketType_1=Regular
ddlTxt_DocketType_2=Bussiness
ddlTxt_DocketType_3=Group
lbl_DocketType=Docket Type
lbl_DocketDescription=Docket Description
lbl_PnrNumber=Pnr Number
btnMain_RtrPnr=Execute
lbl_BussinessClients=Bussiness Clients